|||||||||||||||||||||||||||||||||||||||||||||||||||
|---|-------|---#####-------|---------|-------|---|
|-|-|||-|||-|||||||||||-|||-|-|||||||-|||-|||||---|
|-|---|-|-|-----------|-|-|---|-----|-----|---|---|
|-|||-|-|-|||###|||||-|-|-|||||-|||||||||||||-|||-|
|-|-|---|-----------|-|-|-##--|-------|-------|-|-|
|-|-|||||-|||-|||||||-|-|-|-|||-|||-|||-|||-|-|-|-|
|-|---------|-|-------|-|-|-----|---|---|-|-|---|-|
|-|-|||||||-|||-|||||||-|||||-|||-|||-|||-|-|||-|-|
|-|-|-----|---|---|-----|---|---|---------|-|-|-|-|
|-|||-|||-|||-|||-|||-|||-|-|||-|||||||||||-|-|-|-|
|-|---|-------|-|---|-----|-|---|-|-------|-|---|-|
|-|-||||||#||-|-|||-|||-|||-|||-|-|-|||||-|-|-|||-|
|-|----#|---|-|---|---|---|---|---|-|-----|-|-|---|
|-|-|-##|-|||-|||-|||-|||||||-|||-|-|||-|||-|-|-|||
|-|-|##-|----#--|---|-|--###--|---|---|-----|-|-|-|
|-|-|#--|||||||-|-|-|-|-||#||||-|||||-|||||||-|-|-|
|-|-|#------|---|-|-|---|-----|---|-|-------##|---|
|-|||||||||-|-|||-|||||||-|||||||-|-|||||-|-##|||-|
|-|#------|-|-----|-----|-------|---|---|-|-##--|-|
|-|-|||||-|-|||||||-|-|||-|||||-|||-|-|-|||#|||||-|
|###|-----|---------|-----|##-|-----|-|---|######-|
|-|||-|||||||||||||||||||||#|-|||||||-|||-|#----#-|
|---|-----------------######|##---------|----##---|
|||||||||||||||||||||||||||||||||||||||||||||||||||
